ppppppppppp
p.........p
p.........p
p...s.....p
p.........p
p....O....p
p.........p
ppppppppppp

player 1 4 4